
        #####
       ##   ###
      ### $   #
########### # ##
##   #.  ## .$ #
#  $   $ ## *   #
 #### *.*##.###.#
   #  $ $ #.# .  #
   #  $$$   *. * #
    # $ *#$$# *. #
    #   # . #.. ##
     ##   #######
      ###   @##
         ####